____G__X
_J_XXX__
X______X
__XXXX__
___X____
__S__X__